1111111111111111111111111111111111
1P0000000000000C0000000000000000E1
10000000000000C0C00000000000000001
1000000000000CH00C0000000000000001
100000000000C00000C00000000000V001
10000000000C00H0000C00000000000001
1000000000C000000000C0000000000001
100V00V00C0V00H00V000C0000V00V0001
10000000C0000000000000C00000000001
1000000C000000H00000000C0000000001
100000C00000000000000000C000000001
10000C00000000H0000000000C00000001
1000C000000000000000000000C0000001
100C0000000000H000000000000C000001
10C0000000000000000000000000C00001
1C000000000000H00000000000000C0001
10C000000000000000000000000000C001
100C0000000000H0000000000000000C01
1000C000000000000000000000000000C1
1111111111111111111111111111111111