111111111111111111111111111111
1P0000000000000000000000000001
101111111111110000000011100001
10000000000000VVV0110000000001
100000000000000000110000000001
100000000001000000000100000001
101111110001110110VVV1001H0001
100000000000000000000111110001
101111110000100000000100000001
101E000100001000000000000000H1
10100V0100001001111111100000H1
1010000100001000000000000000H1
1010000100001VV1111111100V0001
100000VH0000100CC0CC0000000001
1000001100001001100001100000H1
100000110000100000000000000001
1VV00000000V100000000000000001
1111111111111111111111111110V1
101010101010111111111111111111
111111111111111111111111111111