1111111111111111111111111111111111
1P00CCCCCCCCCCCCCCCCCCCCCCCCCCCCC1
1111111111111111111111111111111101
1CCCCCCCCCCCCCCCCCCCCCCCCCCCCCCCC1
1011111111111111111111111111111111
1CCCCCCCCCCCCCCCCCCCCCCCCCCCCCCCC1
1111111111111111111111111111111101
1E00000000000000000CCCCCCCCCCCCCC1
1111111111111111111111111111111111