1111111111111111111111111111111111
1P0000000000000C0000000000000001E1
10000000000000C0C0000000000000C101
1000000000000CH00C0000011111111101
100000000000C00000C00000000000V101
10000000000C00H0000C00000000000101
1000000000C000000000C0000000000101
100V00V00C0V00H00V00VC0000V00V0001
10000000C0000000000000C00000000001
1111111111111111111111111111111111